%%%%%%%%%%%%%%%%%%%%%%%%%%%%%%
%.......%...%..............%.%
%.......%.%.%.%%.%.%%%%%.%.%.%
%.......%..G.....%.......%...%
%%%%%.%%%%%.%%%.%%.%%%%%.%.%.%
%.....%...%........%.....%...%
%.%%%.%.%.%.%%..%%%%.%.%.%%%.%
%.......%.....%......%.%.%...%
%%%.%.%%%%%%%.%.%%.%%%.%.%.%.%
%.............%............%.%
%.%.%%%%%.%.%%%%.%.%%%.%.%...%
%...%.....%......%.....%.%%%.%
%....P%%%%%......%.....%.....%
%%%%%%%%%%%%%%%%%%%%%%%%%%%%%%
