%%%%%%%%%
%     . % 
%    . .%  
%%.. %%%%       
% PG    %
%       %
%       %
%%%%%%%%%
