%%%%%%%%%
%P..    % 
% G.% %%%  
%     %%% 
%%%%%%%%%
